1111111111111111111111111111111
1C1010000C1001C00000000000000C1
101C001101100111C10111111110111
101110C1000001E11101C0000C101C1
1000111111000000010111011110101
101000000111100001C1C101C000001
1C10000000000000011101011101101
1111111111111000000001001C01001
1000000100000000000111101111101
10111001010110001111C00000P0001
1C1000000100110001C111111000001
11101111111001000101C1C10000001
10001C1000000111000100010000001
101110110001C1C0001110110001111
101C100111011111001C1000000E001
1C1000000000C1C0000010000000001
1111111111111111111111111111111
