11111
10P01
10001
1C0E1
11111
