1111111111111111111111111111111111
1E0000000000000C00100C001000000001
1001010100100000101001111000010101
10010100101010100C1001C00000110101
1001C000100010001110000010P0100001
11C100001C00C0000000000010001000C1
1111111111111111111111111111111111
