111111111
1C00P00E1
111111111
