1111111111111
0001000000001
1000011111001
1N00110000001
1111111111111
