11111
10001
10001
100E1
11111
