11111
10E01
10001
10001
10001
10001
10001
11111
